XXXXXXXXXXXXXXXXXXXXX
P     X       X   X X
X XXXXX XXXXXXX X X X
X     X       X X   X
X XXX XXXXXXX X XXX X
X X   X     X   X X X
XXX XXX X XXXXXXX X X
X   X   X   X       X
X XXX XXXXX X XXXXXXX
X   X X     X     X X
XXX X X XXX XXXXX X X
X   X X   X X     X X
X XXX XXX X X XXXXX X
X   X X X X X   X   X
XXX X X X XXXXX XXX X
X   X   X     X   X X
X XXXXX XXXXX XXX X X
X     X   X X X   X X
X XXX XXX X X X XXX X
X   X       X       K
XXXXXXXXXXXXXXXXXXXXX
