XXXXXXXXXXX
P         X
XXXXX XXX X
X   X   X X
XXX XXX XXX
X X   X   X
X XXX X X X
X X   X X X
X X XXXXX X
X         K
XXXXXXXXXXX
