XXXXXXXXXXXXXXXXXXXXX
P   X       X       X
X X XXX XXX XXX XXX X
X X X   X     X   X X
X X X XXXXXXX XXXXX X
X X X X     X       X
XXX X X XXX XXXXXXX X
X   X X   X     X   X
X XXX XXX XXXXX XXXXX
X X       X   X     X
X XXXXXXX X X X XXX X
X       X X X X   X X
XXXXXXX XXX X XXXXX X
X     X   X X     X X
X X XXXXX X XXXXX X X
X X     X   X   X   X
XXXXXXX XXXXX X XXX X
X         X   X   X X
X XXXXXXXXX XXXXX X X
X               X   K
XXXXXXXXXXXXXXXXXXXXX
